wwwwwwwwwwwwwww
w.............w
w.............w
w.wwww........w
w....ww....w..w
w.w...w..ww...w
w.w...www.....w
w.w...ww......w
w.............w
w.............w
w.............w
w.............w
w....p........w
w.............w
wwwwwwwwwwwwwww
