wwwwwwwwwwwwwww
w.............w
w.............w
w.............w
w.............w
w.............w
w.....ww......w
w.....ww......w
w.............w
w.............w
w.............w
w.............w
w....p........w
w.............w
wwwwwwwwwwwwwww
